##########
#P.......#
#..###...#
#..#.#...#
#..###...#
#........#
#...B....#
##########
